..#####.#####..
..#...###...#..
..#.C.#.#.C.#..
#####G#S#G#####
#.y.B.....R.y.#
#.C.#b...r#.C.#
#####C.P.C#####
#.C.#b...r#.C.#
#...R..C..B...#
######Y#Y######
....#..#..#....
....#.C#C.#....
....#..#gg#....
....#######....
