..#######.........
..#..C..#.........
..#.....#.........
..#..#..##########
###..#..........C#
#....##.....DDP..#
###..#..........C#
..#..#..##########
..#.....#.........
..#..C..#.........
..#######.........
