..#######.........
..#..C..#.........
..#.....#.........
..#..#..##########
###..#...ww.....C#
#....##..ww.DDP..#
###..#...ww.....C#
..#..#..##########
..#.....#.........
..#..C..#.........
..#######.........
